00,00,00,00,00,00,00,00,00,00,00,00,00,00,00,00,00,00,00,00,00,00,00,00,00,00,00,00,00,00,00,00
00,00,00,00,00,00,00,00,00,00,00,00,00,00,00,00,00,00,00,00,00,00,00,00,00,00,00,00,00,00,00,00
00,00,00,00,01,02,02,02,02,02,02,02,02,02,02,02,03,00,00,00,00,00,00,00,00,00,00,00,00,00,00,00
00,00,00,00,02,10,10,10,10,07,08,10,10,10,10,10,10,02,02,02,02,02,02,03,00,00,00,00,00,00,00,00
00,00,00,00,02,10,10,10,07,06,05,06,07,10,10,10,10,10,10,10,10,10,10,10,03,00,00,00,00,00,00,00
00,00,00,01,10,10,10,07,06,05,05,05,06,08,08,08,10,10,10,10,07,07,10,10,10,02,03,00,00,00,00,00
00,00,00,02,10,10,07,06,05,05,05,05,05,05,05,05,06,07,10,07,06,06,07,10,07,07,10,10,03,00,00,00
00,00,01,10,10,07,06,05,05,05,05,05,05,05,05,05,05,06,08,06,05,05,06,08,06,06,07,10,10,03,00,00
00,00,02,10,07,06,05,05,05,05,05,05,05,05,05,05,05,05,05,05,05,05,05,05,05,05,06,07,10,10,03,00
00,00,03,10,07,06,05,05,05,05,05,05,05,05,05,05,05,05,05,05,05,05,05,05,05,05,06,07,10,10,02,00
00,00,00,03,10,07,06,05,05,05,05,05,05,05,05,05,05,05,05,05,05,05,05,05,06,07,10,10,10,10,03,00
00,00,00,00,02,10,07,06,05,05,06,06,05,05,05,05,05,05,05,05,05,05,05,06,07,10,10,10,10,03,00,00
00,00,00,00,03,10,10,07,06,06,07,07,06,05,05,05,05,05,05,05,05,05,06,07,10,10,10,10,03,00,00,00
00,00,00,00,00,03,10,10,07,07,10,10,07,06,05,05,05,05,05,05,05,05,06,07,10,10,10,03,00,00,00,00
00,00,00,00,00,00,03,10,10,02,10,10,10,07,06,05,05,05,05,05,05,05,05,08,10,10,03,00,00,00,00,00
00,00,00,00,00,00,00,03,03,00,03,10,10,07,06,05,05,05,05,05,05,05,06,10,10,03,00,00,00,00,00,00
00,00,00,00,00,00,00,00,00,00,00,02,10,06,05,05,05,05,05,05,05,05,08,10,02,00,00,00,00,00,00,00
00,00,00,00,00,00,00,00,00,00,00,02,10,05,05,05,05,05,05,05,05,05,08,10,02,00,00,00,00,00,00,00
00,00,00,00,03,04,04,03,00,00,00,02,10,07,06,05,05,05,05,05,05,05,08,10,02,00,00,00,00,00,00,00
00,00,00,00,04,05,05,04,00,00,00,02,10,10,07,05,05,05,05,05,05,05,06,07,02,00,00,00,00,00,00,00
00,00,00,00,03,04,04,03,00,00,00,02,10,10,07,05,05,05,05,05,05,05,05,06,07,03,00,00,00,00,00,00
00,00,00,00,00,00,00,00,00,00,03,10,10,07,06,05,06,08,08,08,06,05,05,06,07,10,03,00,00,00,00,00
00,00,00,00,03,02,03,00,00,03,10,10,07,06,05,06,07,10,10,10,07,06,06,07,10,10,02,00,00,00,00,00
00,00,00,03,06,06,02,00,03,10,10,10,07,06,06,07,10,10,02,02,10,07,07,10,10,10,03,00,00,00,00,00
00,00,00,02,06,06,02,00,02,10,10,10,10,07,07,10,10,03,00,00,03,10,10,10,10,03,00,00,00,00,00,00
00,00,00,03,02,02,03,00,03,10,10,10,10,10,10,10,03,00,00,00,00,02,10,10,03,00,00,00,00,00,00,00
00,00,00,00,00,00,00,00,00,03,10,10,10,10,02,03,00,00,00,00,00,03,02,03,00,00,00,00,00,00,00,00
00,00,00,00,00,00,00,00,00,00,03,02,02,03,00,00,00,00,00,00,00,00,00,00,00,00,00,00,00,00,00,00
00,00,00,00,00,00,03,02,03,00,00,00,00,00,00,00,00,00,00,00,00,00,00,00,00,00,00,00,00,00,00,00
00,00,00,00,00,00,03,02,03,00,00,00,00,00,00,00,00,00,00,00,00,00,00,00,00,00,00,00,00,00,00,00
00,00,00,00,00,00,00,00,00,00,00,00,00,00,00,00,00,00,00,00,00,00,00,00,00,00,00,00,00,00,00,00
00,00,00,00,00,00,00,00,00,00,00,00,00,00,00,00,00,00,00,00,00,00,00,00,00,00,00,00,00,00,00,00